# Resources from graph.properties
alreadyConnected=Nós já conectados 
cancel=Cancelar
close=Fechar
collapse-expand=Colidir/Expandir
containsValidationErrors=Contém erros de validação
done=Feito
doubleClickOrientation=Doubleclick para mudar a orientação
error=Erro
errorSavingFile=Erro ao salvar arquivo
ok=OK
updatingDocument=Atualizando documento. Aguarde...
updatingSelection=Atualizando seleção. Aguarde...
# Custom resources
about=Sobre
actualSize=Tamanho atual
add=Adicionar
addLayer=Adicionar camada
addProperty=Adicionar Propriedade
addToExistingDrawing=Adicionar a desenho existente
addWaypoint=Adicionar Marcação
advanced=Avançado
align=Alinhar
alignment=Alinhamento
allChangesLost=Todas as alterações serão perdidas!
angle=Ângulo
apply=Aplicar
arc=Arco
arrange=Organizar
arrow=Seta
arrows=Setas
automatic=Automático
autosave=Salvamento automático
autosize=Redimensionamento automático
background=Background
backgroundColor=Cor de fundo
backgroundImage=Imagem de fundo
basic=Básico
block=Bloquear
blockquote=Bloco de citações
bold=Negrito
border=Borda
borderWidth=Largura da borda
borderColor=Cor da borda
bottom=Baixo
bottomAlign=Alinhar a baixo
bottomLeft=Bottom Left
bottomRight=Bottom Right
bulletedList=Lista com marcadores
cannotOpenFile=Não foi possível abrir o arquivo
center=Centro
change=Alterar
changeOrientation=Alterar orientação
circle=Círculo
classic=Clássico
clearDefaultStyle=Limpar estilo padrão
clearWaypoints=Limpar marcadores
clipart=Clipart
collapse=Colidir
collapseExpand=Colidir/Expandir
collapsible=Colidível
comic=Comic
connect=Conectar
connection=Conexão
connectionPoints=Pontos de conexão
connectionArrows=Setas de conexão
constrainProportions=Restringir proporções
copy=Copiar
copyConnect=Copiar ao conectar
copySize=Copiar tamanho
create=Criar
curved=Curvado
custom=Customizar
cut=Cortar
dashed=Tracejadas
decreaseIndent=Reduzir identação
default=Default
delete=Deletar
deleteColumn=Deletar coluna
deleteRow=Deletar linha
diagram=Diagrama
diamond=Diamante
diamondThin=Diamonte (fino)
direction=Direção
distribute=Distribuir
divider=Divisor
documentProperties=Propriedades do documento
dotted=Pontilhado
drawing=Desenhando {1}
drawingEmpty=O desenho está em branco
drawingTooLarge=O desenho é muito grande
duplicate=Duplicar
duplicateIt=Duplicar {1}
east=Leste
edit=Editar
editData=Editar Dados
editDiagram=Editar Diagrama
editImage=Editar Imagem
editLink=Editar Link
editStyle=Editar Estilo
editTooltip=Editar Tooltip
enterGroup=Entrar no Grupo
enterValue=Inserir Valor
enterName=Inserir Nome
enterPropertyName=Inserir Nome da Propriedade
entityRelation=Relação de entidade
exitGroup=Sair do Grupo
expand=Expandir
export=Exportar
extras=Extras
file=Arquivo
fileNotFound=Arquivo não encontrado
filename=Nome do arquivo
fill=Preencher
fillColor=Preencher cor
fitPage=Uma página
fitPageWidth=Largura da Página
fitTwoPages=Duas páginas
fitWindow=Ajustar janela
flip=Girar
flipH=Girar na Horizontal
flipV=Girar na Vertical
font=Fonte
fontFamily=Fonte Family
fontColor=Cor da Fonte
fontSize=Tamanho da Fonte
format=Formatar
formatPanel=Formatar Painel
general=Allgemein
formatPdf=PDF
formatPng=PNG
formatGif=GIF
formatJpg=JPEG
formatSvg=SVG
formatXml=XML
formatted=Formatado
formattedText=Texto Formatado
gap=Lacuna
glass=Vidro
general=Geral
global=Global
gradient=Gradiente
gradientColor=Cor
grid=Grade
gridSize=Tamanho da Grade
group=Agrupar
guides=Guias
heading=Cabeçalho
height=Altura
help=Ajuda
hide=Esconder
hideIt=Esconder {1}
hidden=Escondido
home=Home
horizontal=Horizontal
horizontalFlow=Fluxo Horizontal
horizontalTree=Árvore Horizontal
html=HTML
id=ID
image=Imagem
images=Imagens
import=Importar
increaseIndent=Inserir identação
insert=Inserir
insertColumnBefore=Inserir coluna à esquerda
insertColumnAfter=Inserir coluna à direita
insertHorizontalRule=Inserir regra horizontal
insertImage=Inserir Imagem
insertLink=Inserir Link
insertRowBefore=Inserir Linha Acima
insertRowAfter=Inserir Linha Abaixo
invalidName=Nome Inválido
invalidOrMissingFile=Arquivo inválido ou perdido
isometric=Isométrico
italic=Itálico
layers=Camadas
landscape=Paisagem
laneColor=Faixa de cor
layout=Layout
left=Esquerda 
leftAlign=Alinhar à esquerda 
leftToRight=Alinhar à direita
line=Linha
link=Link
lineJumps=Pular linha
lineend=Fim da linha
lineheight=Altura da linha
linestart=Começo da linha
linewidth=Largura da Lista
loading=Carregando
lockUnlock=Bloquear/Desbloquear
manual=Manual
middle=Meio
misc=Misc
more=Mais
moreResults=Mais resultados
move=Mover
moveSelectionTo=Mover seleção para {1}
navigation=Navigação
new=Novo
noColor=Sem cor
noFiles=Sem arquivos
noMoreResults=Sem mais resultados
none=Vazio
noResultsFor='{1}' não foi encontrado
normal=Normal
north=Norte
numberedList=Lista enumerada
opacity=Opacidade
open=Abrir
openArrow=Abrir Seta
openFile=Abrir Arquivo
openLink=Abrir Link
openSupported=Formato de arquivo suportado é .XML salvo apartir deste software
openInNewWindow=Abrir em nova janela
openInThisWindow=Abrir nesta janela
options=Opções
organic=Organico
orthogonal=Ortogonal
outline=Mini mapa
oval=Oval
pages=Páginas
pageView=Visualização da página
pageScale=Escala da página
pageSetup=Configurações da página
panTooltip=Espaço + Arrastar para rolar
paperSize=Tamanho do papel
paste=Colar
pasteHere=Colar aqui
pasteSize=Colar tamanho
pattern=Padrão
perimeter=Perimetro
placeholders=Placeholders
plusTooltip=Clique para conectar e clonar (ctrl + clique para clonar, shift+clique para connectar). Arrastar para conectar (ctrl+ rolar para clonar).
portrait=Retrato
position=Posição
posterPrint=Imprimir poster
preview=Prévia
print=Imprimir
radialTree=Árvore radial
redo=Refazer
removeFormat=Limpar formatação
removeFromGroup=Remover do grupo
removeIt=Remover {1}
removeWaypoint=Remover Marcação
rename=Renomear
renameIt=Renomear {1}
replace=Substituir
replaceIt={1} já existe. Você quer substituir por este?
replaceExistingDrawing=Substituir desenho
reset=Resetar
resetView=Resetar Visão
reverse=Reverter
right=Direita
rightAlign=Alinhar à direita
rightToLeft=Alinhar à esquerda 
rotate=Rotacionar
rotateTooltip=Clique and arraste para rotacionar, clique para girar 90°
rotation=Rotação
rounded=Arredondado
save=Salvar
saveAs=Salvar em
saved=Salvar
scrollbars=Barra de rolagem
search=Buscar
searchShapes=Buscar componente
selectAll=Selecionar Todos
selectEdges=Selecionar Arestas
selectFont=Selecionar Fonte
selectNone=Selecionar Nada
selectVertices=Selecionar Vértices
setAsDefaultStyle=Alterar o estilo padrão  
shadow=Sombra
shape=Forma
sharp=Afiado
sidebarTooltip=Clique para expandir. Arraste e solte as formas no diagrama. Shift+click para alterar seleção. Alt+click para inserir e conectar.
simple=Simples
simpleArrow=Seta Simples
size=Tamanho
solid=Sólido
sourceSpacing=Espaçamento de Fonte
south=Sul
spacing=Espaçamnto
straight=Direto
strokeColor=Cor da Linha
style=Estilo
subscript=Subescrito
superscript=Sobrescrito
table=Tabela
targetSpacing=Alvo de espaçamento
text=Texto
textAlignment=Alinhamento de Texto
textOpacity=Opacidade do Texto
toBack=Para trás
toFront=Para frente
tooltips=Tooltips
top=Topo
topAlign=Alinhar ao topo
topLeft=Topo para esquerda
topRight=Topo para direita
transparent=Transparente
turn=Rotacionar 90º
uml=UML
underline=Underline
undo=Desfazer
ungroup=Desagrupar
url=URL
untitledLayer=Camada sem título
vertical=Vertical
verticalFlow=Fluxo Vertical
verticalTree=Árvore Vertical
view=Visualizar
waypoints=Marcações
west=Oeste
width=Largura
wordWrap=Quebra de linha
writingDirection=Direção de escrita
zoom=Zoom
zoomIn=Aumentar Zoom 
zoomOut=Diminuir Zoom
# USINN
navigationElements=Elementos de Navegação
interactionElements=Elementos de Interação
usabilityElements=Elementos de Usabilidade
